1,2,7,4
****************************
*►       B      ¶      *   *
*    ***  ****         *   *
*****        ***************
*¶    W **   B             *
*       **      «          *
*****        ***************
*#  §***  ****   ***********
*           B              *
****************************