3,1,3,15
****************************
** ▀            W   *      *
*►*    K   *        *      *
*  *      * *  §    *      *
*   *    * W *      *      *
**   *  *     *  ***********
*▀*   **   *               *
* W*      * *              *
*        *   *            «*
****************************