1,2,3,11
****************************
*► *                      ¶*
*  *                     h *
*  *       §               *
*  *        *****       ****
* **        *   *       *s *
*           *****       *  *
*      h                   *
*                       * «*
****************************