2,1,7,15
****************************
*►******************    ****
* *   *    *¶       **   ***
* * * * ** * *           ***
* *   *    *             ***
* ***▀****T ***T ***********
* *** ****  ***  ***********
*              §          «*
****************************
****************************