1,2,8,12
****************************
*► **¶***********   ********
** **ƒ*****  T  *  *       *
** ** ***** **** ***       *
** ** **  * ****«          *
*ƒ                    ******
** ** **  * ****           *
** ** ***** ****          #*
** **T***** §              *
****************************