1,2,8,6
****************************
*►    H             *      *
* **   **   **      *      *
* *    *K   *       *      *
* *    *    *        *     *
* * *  *«*  *K*       *    *
* * *  * *  * *        *****
* ***  ***  *** ¶          *
*     §    H               *
****************************