1,2,3,15
****************************
*►  *   ** H          ******
*#  * ƒ **            ******
*  H*  ****  * §      ******
* ***        *         *****
*   *        ***      *    *
**  *  ****  *        *    *
**      **   * ƒ       *****
**    ƒ **   *« ▀          *
****************************