1,2,2,16
****************************
*►  *        *       *     *
*   *        *  §    *     *
*  **  £     **      *******
*                          *
* s      «                 *
*****                  ** s*
*   *                  *   *
*   *                  *¶  *
****************************