1,2,2,7
****************************
*►       *£                *
*      § *      ▀          *
******   *  ****************
*£  «*   *  *              *
*    *   *  *              *
*  ***      ****************
*                          *
*        *      B         #*
****************************