1,2,3,11
******************
*► *            ¶*
*  *           õ *
*  *       §     *
*  *          ****
* **          *¥ *
*             *  *
*      õ         *
*             * «*
******************