1,2,8,12
******************
*► **¶************
** **ƒ*****  Ý   *
** ** ***** **** *
** ** **  * ****«*
*ƒ          ******
** ** **  * **** *
** ** ***** ****#*
** **Ý***** §    *
******************