2,1,7,15
******************
*►****************
* *   *    *¶  ***
* * * * ** * * ***
* *   *    *   ***
* ***▀****Ý***Ý***
* *** **** *** ***
*              §«*
******************
******************