1,2,2,16
******************
*►  *        *   *
*   *        *  §*
*  **  £     **  *
*                *
* ¥      «       *
*  **        ** ¥*
*   *        *   *
*   *        *¶  *
******************