1,2,2,7
******************
*►       *£      *
*      § *      ▀*
******   *  ******
*£  «*   *  *    *
*    *   *  *#   *
*  ***      ***  *
*                *
*        *      ß*
******************