3,1,3,15
******************
** ▀            ß*
*►*    W   *     *
*  *      * *  § *
*   *    * ß *   *
**   *  *     *  *
*▀*   **   *     *
* ß*      * *    *
*        *   *  «*
******************