1,2,7,4
******************
*►       ß      ¶*
*    ***  ****   *
*****        *****
*¶    ß **   ß   *
*       **      «*
*****        *****
*#  §***  ****   *
*           ß    *
******************